25;blue;
#########################
#########################
###.........#.........###
###.##.####.#.####.##.###
###*##.####.#.####.##*###
###...................###
###.##.#.#######.#.##.###
###....#....#....#....###
######.####O#O####.######
######.#OOOOFOOOO#.######
######.#O###O###O#.######
OOOOOO.OO##FFF##OO.OOOOOO
######.#O#######O#.######
######.#OOOOOOOOO#.######
######.#O#######O#.######
###.........#.........###
###.##.####.#.####.##.###
###*.#......P......#.*###
####.#.#.#######.#.#.####
###....#....#....#....###
###.#######.#.#######.###
###...................###
#########################
#########################
#########################
