25;green
#########################
#########################
#########################
OOOO.................OOOO
####.#.#####.#####.#.####
####.#......P......#.####
####.#.#####.#####.#.####
###..#.....#.#.....#..###
###.######.#.#.######.###
###...*#.........#*...###
###.##...#.#.#.#...##.###
###.####.#.#.#.#.####.###
###......#.#.#.#......###
####.#####.....#####.####
####...###.#.#.###...####
###..#.....#.#.....#..###
###.######.#.#.######.###
###....#...#.#...#....###
####.#...###.###...#.####
####.###.###.###.###.####
####.*.#....F....#.*.####
####.#.#.###O###.#.#.####
OOOO.....##FFF##.....OOOO
#########################
#########################
